XXXXXXXXXXXXXXXXXXXXXXXXXXXXXXXXXXXXXXXXX
X   X X X     X           X           X X
X X X X XXX X XXXXX X X XXX XXXXX XXXXX X
X X X X X   X     X X X         X       X
XXX X X XXXXX XXX X XXXXX X XXX XXXXXXXXX
X   X   X   X X X       X X X X     X   X
X X XXX XXX XXX X X X XXX X X XXX XXX XXX
X X X   X       X X X   X X   X       X X
XXX XXX XXXXX X X X XXX X X X X X XXX X X
X X       X   X   X   X X X X X X   X   X
X X X XXX XXXXXXX X XXX XXXXXXX XXXXXXX X
X   X X           X   X       X     X X X
XXX X XXX XXX XXX XXX X XXXXXXXXXXXXX X X
X   X X     X X   X X X           X     X
X X XXXXX X XXXXX X X XXXXXXXXXXX X XXX X
X X   X   X   X     X       X X X X X X X
XXX X X XXX XXX X XXX X XXX X X XXXXX XXX
X   X X X X X   X X   X   X             X
XXX XXXXX X XXXXXXX X X XXX XXXXX XXX XXX
      X       X     X X   X X       X X X
X XXX XXX XXXXX XXXXX X XXX X XXXXX XXX X
X   X X   X X       X X   X X   X       X
X X XXXXX X XXXXXXXXX X XXX XXXXXXX X XXX
X X X           X X   X X     X     X    
X XXXXX X X X XXX XXX XXXXX XXX X XXXXXXX
X X     X X X     X       X   X X       X
XXX X X X XXX XXX X X XXX XXXXX X X X XXX
X   X X X   X X   X X X       X X X X   X
X XXXXX XXX X XXXXXXXXX X XXX XXX XXXXX X
X X       X X X         X   X X   X     X
X XXX XXX X XXXXX X X XXX XXX XXX X XXX X
X   X X X X   X   X X   X   X X X X X   X
X XXX X XXX XXXXXXXXX XXX XXXXX XXXXXXX X
X   X     X X X         X     X   X X   X
XXXXX XXX XXX X XXXXX XXXXX XXX X X X X X
X       X     X X       X X     X X   X X
XXXXXXX XXXXX X X X XXX X XXX X XXX XXX X
X X       X   X X X X   X   X X X     X X
X X X X XXXXX X X X XXX X XXXXX XXXXXXX X
X   X X   X   X X X X       X     X     X
XXXXXXXXXXXXXXXXXXXXXXXXXXXXXXXXXXXXXXXXX
