XXXXXXXXXXXXXXXXXXXXXXXXXXXXXXXXXXXXXXXXX
X   X X   X X X     X   X   X       X   X
XXX X X XXX X XXXXX XXX X XXX X XXXXX XXX
X X   X   X X X X   X         X       X X
X XXX XXX X X X X XXX XXXXXXXXXXX X XXX X
X             X     X       X   X X X   X
XXXXXXX X XXXXXXX XXXXX X XXX XXXXXXX XXX
X X X   X X X       X X X   X X   X X   X
X X XXX XXX XXXXX XXX XXX XXX XXX X X XXX
X X       X X           X X X X         X
X XXXXX XXX XXXXXXX XXXXX X X XXX XXXXXXX
X   X X X X X X X     X X     X       X X
X X X X X X X X XXX XXX XXX XXXXX XXX X X
X X X     X X X X     X X X X X X   X    
XXX XXX XXX X X XXXXX X X X X X XXX X XXX
X   X     X X X     X X X   X       X X X
XXX XXXXX X X XXXXX X X X XXX X XXX XXX X
X     X     X     X           X   X X   X
XXX X X X XXXXX XXXXXXX XXXXXXXXX XXXXX X
X   X   X     X   X   X X       X   X X X
XXXXXXXXXXX XXX XXXXX X X XXXXXXXXX X X X
X         X               X       X X X X
XXX X X X XXXXXXX X X XXXXX XXXXX XXX X X
X   X X X         X X       X   X   X   X
XXXXXXX X XXX XXX X X XXXXXXX XXXXXXX XXX
X X     X X   X   X X             X X   X
X XXX X XXXXX XXX XXXXXXX XXX X XXX X X X
X     X X     X         X X   X       X X
XXX XXXXXXXXX X X X X X XXX X XXX XXXXX X
X       X X X X X X X X   X X   X     X X
X X XXXXX X XXXXX X X XXXXXXX X XXXXXXXXX
X X X             X X   X X   X   X   X X
X XXXXXXXXX XXXXX X XXX X XXXXX X X XXX X
X   X         X   X   X       X X     X X
XXX X XXX XXX X X X XXX X XXX XXXXX XXX X
X   X X   X   X X X X   X   X     X     X
X XXX XXXXX X X XXX X XXX XXX XXX X XXX X
X X   X     X X   X X X     X   X X   X X
X X X XXXXX XXX XXX XXX X XXXXX XXXXXXXXX
  X X X     X   X   X   X     X         X
XXXXXXXXXXXXXXXXXXXXXXXXXXXXXXXXXXXXXXXXX
